,국어,영어,수학,사회,과학,총점
OQvsL,69,71,8,23,82,253
vkjjo,69,42,10,63,26,210
bgntI,66,12,69,46,16,209
aRZvW,60,97,9,11,49,226
zjlaK,86,89,49,88,39,351
TErol,8,32,30,0,28,98
TiEUV,49,19,69,23,81,241
uofgI,2,55,65,26,32,180
XXFqB,58,45,53,4,5,165
WVxAm,97,66,82,51,50,346
